R 1024 762
NO ./textures/hofmann.xpm
SO ./textures/blot2.xpm
WE ./textures/david.xpm
EA ./textures/frankenchrist.xpm
S  ./textures/blot2.xpm
F 220, 100, 0
C 50, 90, 255
111111111111111111111111110
1000000000110000000000000010
1011000001110000002000001S010
10010000000000000000000010001
10110000011100000000000010001
10000000001100000111011110001
11110111111111011100000010001
1111011111111101110101001000111111111111111
1100000011010101110000001000000000000000001
1000200000000000110000001000111111110111111
10000000000000001101010010001111111101
11000000110101011111011110001111111101
11110111111101011111011110001111111111
10000000001100000000000000001
10000000001100000000000000001
10000000001100000000000000001
10000000001100010001000000001
100000000011000010100000000001
10000000001100000100000000001
10000000001100000000000000001
10000000001100000000000000001
100000000011000000000000000001
10000000001100000000000000001
10111111111111111111111111111
100000000011000000000000000001
10000000001100000000000000001
10000000001100000000000000001
10000000001100000111111111111
100000000000000001
10000000001100000111111111111
10000000001100000000000000001
10000000001100000000000000001
10000000001100000000000000001
11111111111100000000000000001
10000000001100000000000000001
00000000001100000000000000001
10000000001100000000000111111
1000000000110000000000001
100000000011000000000001
111111011111111111111111
