R 512 512
NO ./textures/hofmann.xpm
SO ./textures/hofmann.xpm
WE ./textures/hofmann.xpm
EA ./textures/hofmann.xpm
S ./textures/hofmann.xpm
F 220,100,0

C 255,30,255
11111
10001
11W01
1011
111
