R 1920 1080
NO ./textures/blot9.xpm
SO ./textures/blot1.xpm
WE ./textures/blot2s.xpm
EA ./textures/blot7.xpm
S  ./textures/hofmann.xpm
F 220, 100, 0
C 50, 90, 255

11111111111111
10000000000001
10000000000000111111111
11111000000000000000001
1000000000011111111
100000000001
100000000001111111
111111110001111111000011111111111
1111111100000000000000111111111
1000000000000001111111111111111
100000N00000000111111111
1111111110000000000000011111111111111111111111
1000000000000000000000001
1000000000000000000000001
1000000111111111111110011
1000000110001
1000000011111111100001
10000000000000011111111101
1111111111111000000000001
11111100111
1001
1111001
1000111111001
1000000001111
100011111
1111
