R 1920 1080
NO ./textures/clapclap.xpm
SO ./textures/grr.xpm
WE ./textures/david.xpm
EA ./textures/frankenchrist.xpm
S  ./textures/bl.xpm
FL ./textures/hofmann.xpm
CE ./textures/aphex.xpm
F 220,100,0
C 50,90,255
11111111111111111111111111111
10000000001100000000000000101
1011000001110000002000001N011
10010000000000000200000010001
10110000011100020000000010001
10000000001100000111011110001
11110111111111011100000010001
1111011111111101110101001000111111111111111
1100000011010101110000001000000000000000001
1000200000000000110000001000111111110111111
10000000000000001101010010001111111101
11000000110101011111011110001111111101
11110111111101011111011110001111111111
10000000001100000000000000001
10000000001100000000000000001
10000000001100000000000000001
10000000001100010001000000001
10000000001100001010000000001
10000000001100000100000000001
10000000001100000000000000001
10000000001100000000000000001
10000000001100000000000000001
10000000001100000000000000001
10111111111111111111111111111
10000000001100000000000000001
10000000001100000000000000001
10000000001100000000000000001
10000000001100000111111111111
100000000000000001
10000000001100000111111111111
10000000001100000000000000001
10000000001100000000000000001
10000000001100000000000000001
11111111111100000000000000001
10000000001100000000000000001
00000000001100000000000000001
10000000001100000000000111111
1000000000110000000000001
100000000011000000000001
111111011111111111111111
