R 0 1080
NO ./textures/david.xpm
SO ./textures/frankenchrist.xpm
WE ./textures/grr.xpm
EA ./textures/blot2.xpm
S ./textures/wolfenstein/pillar.xpm
FL ./textures/hofmann.xpm
CE ./textures/hofmann.xpm

F 220,100,0

C 255,30,255

11111111111111111111111111111
10000000001100000000000000001
1011000001110200002000001N001
10010000000000202000000010001
10110000011102020200000010001
10000000001100000111011110001
11110111111111011100000010001
11110111111111011101010010001
11000000110101011100000010001
10000000000000001100000010001
10000000000000001101010010001
11000000110101011111011110001
11110111111101011111011110001
11111111111111111111111111111
